1111111111111111111
111111P111111111111
1111110C11111111111
1000C00001C1000C001
1000000000010000001
1C0000C00000C000011
1000C11111100000001
1111011111111111111
1111000000E00011111
1111111111111111111